한일 관계 => 한일관계
한중 관계 => 한중관계
한미 관계 => 한미관계
열린 우리당 => 열린우리당
더불어 민주당, 더민당 => 더불어민주당
자유 한국당 => 자유한국당
미래 통합당, 미통당 => 미래통합당
국힘, 국힘당, 국민의 힘 => 국민의힘
통진당, 통합 진보당 => 통합진보당
자민련, 자유 민주연합, 자유 민주 연합, 자유민주 연합 => 자유민주연합
미래 한국당 => 미래한국당
더불어 시민당 => 더불어시민당
국민의 당 => 국민의당
열린 민주당 => 열린민주당
국가 혁명당 => 국가혁명당
대통령 비서실 => 대통령비서실
국가 안보실 => 국가안보실
국가 정보원 => 국가정보원
국가 인권 위원회 => 국가인권위원회
국가 안전 보장 회의 => 국가안전보장회의
민주 평화 통일 자문 회의 => 민주평화통일자문회의
민주 평통 => 민주평통
국가 과학기술자문회의 => 국가과학기술자문회의
대통령 자문회의 => 대통령자문회의
국무 조정실 => 국무조정실
국무 총리 비서실 => 국무총리비서실
국가 보훈처 => 국가보훈처
인사 혁신처 => 인사혁신처
식품의약품안전처, 식품 의약품 안전처 => 식약처
공정위, 공정 거래 위원회, => 공정거래위원회
금융 위원회 => 금융위원회
국민 권익 위원회 => 국민권익위원회
개인정보 보호위원회 => 개인정보보호위원회
원자력 안전 위원회 => 원자력안전위원회
기획 재정부, 기재부 => 기획재정부
국가 과학 기술 정보 통신부, 과기부 => 과학기술정보통신부
행정 안전부 => 행정안전부
문화 체육 관광부, 문체부 => 문화체육관광부
농림 축산 식품부 => 농림축산식품부
산업 통상부 => 산업통상부
보건 복지부 => 보건복지부
고용 노동부 => 고용노동부
여성 가족부, 여가부 => 여성가족부
국토 교통부, 국토부 => 국토교통부
해양 수산부 => 해양수산부
중소 벤처 기업부, 중기부 => 중소벤처기업부
농촌 진흥청 => 농촌진흥청
질병 관리청 => 질병관리청
새만금 개발청, 새만금 => 새만금개발청
해양 경찰청 => 해양경찰청
윤대통령, 윤 대통령, 석열, 석렬, 윤석렬, 윤가 => 윤석열
문대통령, 문 대통령, 문재, 재인 => 문재인
전 대통령 => 전대통령
개딸, 개혁의 딸 => 개혁의딸
통합추진위 => 통합추진위원회
언텍트, 언택트 => 비대면
대한 민국 => 대한민국
준석 => 이준석
재명 => 이재명
건희 => 이건희
준표 => 홍준표
최순 => 최순실
가즈 => 가즈아
세연 => 가로세로연구소